################################################################
#                                                              #
#                                                              #
#                 ###########    #          #                  #
#                 #              #          #                  #
#                 #              #    ##    #                  #
#                 #     #####    #   #  #   #                  #
#                 #         #    #  #    #  #                  #
#                 #         #    # #      # #                  #
#                 ###########    ##        ##                  #
#                                                              #
#                                                              #
#  #############################################################
#  #     #     #     #     #     #     #     #     #     #     #
#  #  #  #  #  #  #  #  #  #  #  #  #  #  #  #  #  #  #  #  #  #
#  #  #  #  #  #  #  #  #  #  #  #  #  #  #  #  #  #  #  #  #  #
#  #  #  #  #  #  #  #  #  #  #  #  #  #  #  #  #  #  #  #  #  #
#  #  #  #  #  #  #  #  #  #  #  #  #  #  #  #  #  #  #  #  #  #
#  #  #  #  #  #  #  #  #  #  #  #  #  #  #  #  #  #  #  #  #  #
#  #  #  #  #  #  #  #  #  #  #  #  #  #  #  #  #  #  #  #  #  #
#  #  #  #  #  #  #  #  #  #  #  #  #  #  #  #  #  #  #  #  #  #
#  #  #  #  #  #  #  #  #  #  #  #  #  #  #  #  #  #  #  #  #  #
#     #     #     #     #     #     #     #     #     #     #  #
#  ##########################################################  #
#                                                              #
#                                                              #
#             ################################                 #
#             #                                                #
#             #  #############################                 #
#             #                              #                 #
#             #                              #                 #
#             #                              #                 #
#             #                              #                 #
#             #                              #                 #
#             #  #############################                 #
#             #                                                #
#             ################################                 #
#                                                              #
#                                                              #
################################################################
