################################
#                              #
#                    #         #
#                  #   #       #
#  #####             #         #
#      #                       #
#      #                       #
#      #   ##                  #
#      #   ##         #        #
#                              #
#                              #
#                              #
######         #################
#                              #
#                              #
#                              #
#                              #
#          #                   #
#           #                  #
#            #                 #
#             #                #
#              #               #
#               #              #
#                #             #
#                 #            #
#                  #           #
#                              #
###########                    #
#         #                    #
#                              #
#         #                    #
###########    #################
#                   #          #
#                   #          #
#                              #
#                   #          #
################################
